Привет как дела? 	я в порядке. как насчет тебя?
я в порядке. как насчет тебя? 	я весьма хорош. Спасибо за вопрос.
я весьма хорош. Спасибо за вопрос. 	без проблем. Так как ты?
без проблем. Так как ты? 	я был великолепен. А вы?
я был великолепен. А вы? 	я был хорошим. я сейчас в школе.
я был хорошим. я сейчас в школе. 	В какую школу ты ходишь?
В какую школу ты ходишь? 	я хожу на пк.
я хожу на пк. 	тебе там нравится?
тебе там нравится? 	все нормально. это действительно большой кампус.
все нормально. это действительно большой кампус. 	удачи в школе.
удачи в школе. 	большое спасибо.
как дела? 	У меня все хорошо. а ты?
У меня все хорошо. а ты? 	никогда не лучше, спасибо.
никогда не лучше, спасибо. 	ну как ты в последнее время?
ну как ты в последнее время? 	я на самом деле был довольно хорош. ты?
я на самом деле был довольно хорош. ты? 	я на самом деле в школе прямо сейчас.
я на самом деле в школе прямо сейчас. 	в какой школе ты учишься?
в какой школе ты учишься? 	Я посещаю ПКС прямо сейчас.
Я посещаю ПКС прямо сейчас. 	тебе там весело?
тебе там весело? 	это не плохо. там много людей.
это не плохо. там много людей. 	Удачи с этим.
Удачи с этим. 	Спасибо.
как у тебя сегодня дела? 	У меня есть успехи. А вы?
У меня есть успехи. А вы? 	Я абсолютно прекрасен, спасибо.
Я абсолютно прекрасен, спасибо. 	у тебя все было хорошо?
у тебя все было хорошо? 	я не был лучше. как насчет тебя?
я не был лучше. как насчет тебя? 	я недавно пошла в школу.
я недавно пошла в школу. 	куда ты идешь в школу?
куда ты идешь в школу? 	я иду на пк.
я иду на пк. 	как вам это нравится до сих пор?
как вам это нравится до сих пор? 	мне пока нравится. мои классы довольно хорошо прямо сейчас.
мне пока нравится. мои классы довольно хорошо прямо сейчас. 	желаю тебе удачи.
сегодня уродливый день. 	я знаю. я думаю, может пойти дождь.
я знаю. я думаю, может пойти дождь. 	сейчас середина лета, сегодня не должно быть дождя.
сейчас середина лета, сегодня не должно быть дождя. 	это было бы странно.
это было бы странно. 	да, тем более, что на улице девяносто градусов.
да, тем более, что на улице девяносто градусов. 	Я знаю, было бы ужасно, если бы шел дождь и было жарко на улице.
Я знаю, было бы ужасно, если бы шел дождь и было жарко на улице. 	да, было бы.
да, было бы. 	Я действительно хочу, чтобы это не было так жарко каждый день.
Я действительно хочу, чтобы это не было так жарко каждый день. 	я тоже. не могу дождаться зимы.
я тоже. не могу дождаться зимы. 	Я тоже люблю зиму, но иногда бывает слишком холодно.
Я тоже люблю зиму, но иногда бывает слишком холодно. 	Я предпочел бы быть холодным, чем горячим.
Я предпочел бы быть холодным, чем горячим. 	я тоже.
снаружи сегодня не очень красиво. 	ты прав. Я думаю, что позже пойдет дождь.
ты прав. Я думаю, что позже пойдет дождь. 	в середине лета не должно быть дождя.
в середине лета не должно быть дождя. 	это было бы неправильно.
это было бы неправильно. 	учитывая, что на улице более девяноста градусов, это было бы странно.
учитывая, что на улице более девяноста градусов, это было бы странно. 	точно, было бы нехорошо, если бы пошел дождь. слишком жарко.
точно, было бы нехорошо, если бы пошел дождь. слишком жарко. 	я знаю, ты абсолютно прав.
я знаю, ты абсолютно прав. 	Я хочу, чтобы это остыло в один прекрасный день.
Я хочу, чтобы это остыло в один прекрасный день. 	Вот как я чувствую, я хочу, чтобы зима пришла скорее.
Вот как я чувствую, я хочу, чтобы зима пришла скорее. 	Я люблю зиму, но иногда бывает очень холодно.
Я люблю зиму, но иногда бывает очень холодно. 	Я знаю, что ты имеешь в виду, но я лучше буду холодным, чем горячим.
Я знаю, что ты имеешь в виду, но я лучше буду холодным, чем горячим. 	именно так я себя чувствую.
Я хочу, чтобы сегодня был хороший день. 	это правда. Я надеюсь, что не будет дождя.
это правда. Я надеюсь, что не будет дождя. 	в середине лета не будет дождя.
в середине лета не будет дождя. 	Было бы неправильно, если бы прямо сейчас пошел дождь.
Было бы неправильно, если бы прямо сейчас пошел дождь. 	было бы странно, если бы пошел дождь в 90-градусную погоду.
было бы странно, если бы пошел дождь в 90-градусную погоду. 	любой дождь прямо сейчас был бы бессмысленным.
любой дождь прямо сейчас был бы бессмысленным. 	правильно, так и было бы.
правильно, так и было бы. 	Я хочу, чтобы он немного остыл.
Я хочу, чтобы он немного остыл. 	Я знаю, что ты имеешь в виду, я не могу дождаться зимы.
Я знаю, что ты имеешь в виду, я не могу дождаться зимы. 	зима отличная. Я бы хотел, чтобы это не становилось таким холодным иногда, хотя.
зима отличная. Я бы хотел, чтобы это не становилось таким холодным иногда, хотя. 	Я бы предпочел иметь дело с зимой, чем летом.
такой хороший день. 	Да, это.
Да, это. 	похоже скоро может пойти дождь.
похоже скоро может пойти дождь. 	да, и я надеюсь, что это так.
да, и я надеюсь, что это так. 	почему это?
почему это? 	Мне очень нравится, как дождь очищает воздух.
Мне очень нравится, как дождь очищает воздух. 	я тоже. после дождя всегда так пахнет свежестью.
я тоже. после дождя всегда так пахнет свежестью. 	да, но я люблю ночной воздух после дождя.
да, но я люблю ночной воздух после дождя. 	Действительно? почему это?
Действительно? почему это? 	потому что ты прекрасно видишь звезды.
потому что ты прекрасно видишь звезды. 	Я очень надеюсь, что сегодня будет дождь.
Я очень надеюсь, что сегодня будет дождь. 	Да, я тоже.
Разве это не хороший день? 	это действительно так.
это действительно так. 	кажется, сегодня может пойти дождь.
кажется, сегодня может пойти дождь. 	надеюсь, так и будет.
надеюсь, так и будет. 	почему?